##############
#####..1.#####
#####T.TV#####
#####VMMM#####
#####MTVG#####
#.VMAMMMMMVT.#
#4TMVMVVMTM..#
#..MTMVVMVMT2#
#.TV.MMMMFMV.#
#####KVTM#####
#####MMMV#####
#####VT.T#####
#####.3..#####
##############