AP#############PG
P2..MMVVMMVVM..1P
#.TMAVTVTMTVTVT.#
#MVMVVVMVMMVMVVM#
#MTVTMTVFMTMKVTV#
#MMVMVMMVMVMVMVM#
#VFMTVTMTVAVTMTM#
#VMVMVVMMVMVVVVM#
#VTMGVTVTVTMTMTV#
#VVMVMVMVMVMVVMM#
#VFMTMTMTMKVTMTV#
#MMVVMMVMMVMVVMV#
#.TVTMTMFVTMTVT.#
P4..VMVMVMMMV..3P
KP#############PF