######APG######
#2..MVVVMVV..1#
#.AMTVTMTVTVG.#
#VMVVMVVVMVVVV#
AVTVTMTVFVTMTMG
PVMVVVMVVMVVVVP
KVTMGVTVTVTVTVF
#VMVMMVVVMVVVM#
#.KVTMTVAVTVF.#
#4..VVVMVVM..3#
######KPF######