###############
#2..GGGGGGG..1#
#.DGDGDGDGDGD.#
#GGGGGGGGGGGGG#
#GDGDGDGDGDGDG#
#GGGGGGGGGGGGG#
#GDGDGDGDGDGDG#
#GGGGGGGGGGGGG#
#.DGDGDGDGDGD.#
#4..GGGGGGG..3#
###############

