##############
#####...1#####
#####D.DG#####
#####GGGG#####
#####GDGD#####
#2GGDGGGGGGD.#
#.DGGGGGGDG..#
#..GDGGGGGGD.#
#.DGGGGGGDGG3#
#####GG#G#####
#####GGGG#####
#####G#.######
#####4...#####
##############