#################
#2..GGGGGGGGG..1#
#.DGDGDGDGDGDGD.#
#GGGGGGGGGGGGGGG#
#GDGDGDGDGDGDGDG#
#GGGGGGGGGGGGGGG#
#GDGDGDGDGDGDGDG#
#GGGGGGGGGGGGGGG#
#GDGDGDGDGDGDGDG#
#GGGGGGGGGGGGGGG#
#GDGDGDGDGDGDGDG#
#GGGGGGGGGGGGGGG#
#.DGDGDGDGDGDGD.#
#4..GGGGGGGGG..3#
#################