##############
#####-+-1#####
######|#.#####
#####....#####
#####.#..#####
#2...XETH..#|#
#|#..H..E#.-+#
#+-.#T..X..#|#
#|#..EXHT...3#
#####..#.#####
#####....#####
#####.#|######
#####4-+-#####
##############