###############
#2-+H.H.HEH+-1#
#|RVRVRVRVRVR|#
#EH.H.H.H.HAH.#
#VRVRVRVRVRVRV#
#.HXH.HTH.H.HE#
#VRVRVRVRVRVRV#
#.HAH.H.HXH.H.#
#|RVRVRVRVRVR|#
#4-+HH.HX.H+-3#
###############