#QQQQQQQQQQQQQQQ#
#2-+GRGRGRGRG+-1#
#|CBCBCBCBCBCBC|#
#RGRGRGRGRGRGRGR#
#BCBCBCBCBCBCBCB#
#RGRGRGRGRGRGRGR#
#BCBCBCBCBCBCBCB#
#RGRGRGRGRGRGRGR#
#BCBCBCBCBCBCBCB#
#RGRGRGRGRGRGRGR#
#BCBCBCBCBCBCBCB#
#RGRGRGRGRGRGRGR#
#|BCBCBCBCBCBCB|#
#4-+GRGRGRGRG+-3#
#QQQQQQQQQQQQQQQ#