##############
#####-+-1#####
#####C|CR#####
#####RRRR#####
#####RCRC#####
#2RRCRRRRRRC|#
#|CRRRRRRCR-+#
#+-RCRRRRRRC|#
#|CRRRRRRCRR3#
#####CRCR#####
#####RRRR#####
#####RC|C#####
#####4-+-#####
##############