#QQQQQQQQQQQQQ#
#2-+GRGRGRG+-1#
#|CBCBCBCBCBC|#
#RGRGRGRGRGRGR#
#BCBCBCBCBCBCB#
#RGRGRGRGRGRGR#
#BCBCBCBCBCBCB#
#RGRGRGRGRGRGR#
#|CBCBCBCBCBC|#
#4-+GRGRGRG+-3#
#QQQQQQQQQQQQQ#