###############
#2.OB.OY.BB..1#
#.#R#Y#.#R#.#.#
#.YOBRBO..YB.R#
#O#.#.#Y#R#O#O#
#RRY..O..RBB.Y#
#B#Y#B#.#.#Y#R#
#O.RO.Y.RO..OB#
#Y#B#.#O#B#.#.#
#4..ROBBORY..3#
###############