#################
#2..BYROBBORB..1#
#.#Y#O#R#B#R#O#.#
#BYYOROBOBYRBORB#
#B#Y#B#R#Y#B#R#O#
#YBBYOBYRBOYRBOB#
#R#Y#R#Y#R#O#Y#B#
#OYOBROBYRBOROOB#
#O#B#R#O#O#B#B#R#
#ORBRYOYRBOYORBY#
#O#B#Y#Y#B#O#B#O#
#BYORBYOBBOBRRYO#
#.#O#B#B#O#Y#O#.#
#4..OYOYOYBYO..3#
#################