##############
#####..1.#####
######.#B#####
#####RYRY#####
#####Y#BR#####
#.BYBOYOOYR#.#
#4#RBOBBY#Y..#
#..Y#YBBOBR#2#
#.#R.OOYOOYB.#
#####YB#Y#####
#####YRYR#####
#####B#.######
#####.3..#####
##############